xxxxxxxxxxxxxxxxxxxxxxxxxxxxxxxxxxxxxxxx
x######################################x
x#....................................#x
x#....................................#x
x#........#####.......................#x
x#........#xxx#.......................#x
x#........#xxx#.......................#x
x#........#####.......................#x
x#....................................#x
x#....................................#x
x#....................................#x
x#....................................#x
x#....................................#x
x#....................................#x
x#....................................#x
x#....................................#x
x#.................S..................#x
x#....................................#x
x#....................................#x
x#....................................#x
x#....................................#x
x#....................................#x
x#....................................#x
x#....................................#x
x#....................................#x
x#....................................#x
x#....................................#x
x#....................................#x
x######################################x
xxxxxxxxxxxxxxxxxxxxxxxxxxxxxxxxxxxxxxxx
